let cols = 7;
let rows = 8;
let innieouties = 5;

let cell_walls = [
	[1,0,1,1,1,1],
	[1,1,1,0,1,0],
	[1,0,1,1,1,0],
	[1,1,1,0,1,0],
	[1,0,0,1,1,1],
	[1,0,1,0,1,0],
	[1,1,1,0,1,0],
	[1,1,0,1,1,0],
	[1,0,1,1,1,0],
	[1,0,1,0,1,1],
	[1,0,1,0,1,1],
	[0,0,0,0,1,1],
	[1,1,1,0,1,1],
	[1,1,0,1,1,0],
	[0,1,0,1,1,1],
	[1,0,1,1,1,0],
	[1,0,1,0,1,1],
	[1,1,1,0,1,0],
	[0,1,1,1,1,0],
	[1,1,0,1,1,0],
	[0,1,0,1,1,1],
	[0,0,0,1,1,1],
	[1,1,0,0,1,1],
	[1,0,1,1,1,0],
	[1,1,1,0,1,1],
	[1,0,0,1,1,1],
	[0,1,1,0,1,1],
	[0,1,0,1,1,1],
	[0,1,1,1,1,1],
	[0,0,1,1,1,1],
	[1,0,1,0,1,1],
	[1,1,0,0,1,1],
	[0,1,0,1,1,1],
	[1,1,0,1,1,0],
	[0,1,1,1,1,0],
	[1,0,0,1,1,1],
	[1,0,1,0,1,1],
	[1,1,1,0,1,0],
	[0,1,0,1,1,0],
	[0,1,1,1,1,0],
	[0,0,1,1,1,0],
	[1,1,1,0,1,1],
	[0,1,1,1,1,0],
	[1,1,0,1,1,0],
	[1,1,0,1,1,0],
	[0,1,1,1,1,1],
	[1,1,0,1,1,0],
	[1,0,0,1,1,1],
	[1,1,1,0,1,0],
	[1,1,1,1,1,0],
	[0,1,1,1,1,0],
	[0,0,1,1,1,1],
	[1,0,1,0,1,1],
	[0,1,1,0,1,1],
	[0,0,1,1,1,1],
	[1,1,1,0,1,0],
	[1,0,1,1,1,0],
	[1,1,1,0,0,1],
	[1,1,1,1,0,0],
	[1,0,1,1,0,1],
	[1,1,0,0,1,1],
	[1,1,1,1,0,0],
	[1,1,1,1,0,0],
	[1,1,1,1,0,0],
	[1,1,1,1,0,1],
	[1,0,1,1,1,0],
	[1,1,0,0,1,1],
	[0,0,1,1,1,1],
	[1,1,0,0,1,1],
	[1,1,1,1,0,0],
	[1,1,1,1,1,0],
	[1,1,1,1,0,0],
	[1,1,1,1,1,0],
	[0,1,1,1,0,1],
	[1,1,1,1,0,1],
	[0,1,1,1,0,1],
	[1,1,0,1,1,0],
	[1,1,0,1,1,0],
	[1,1,0,1,1,1],
	[1,0,1,1,0,0],
	[1,0,1,0,1,1],
	[1,0,1,0,1,1],
	[1,1,0,0,1,1],
	[0,1,1,1,1,0],
	[0,1,0,1,1,1],
	[0,0,1,1,1,1],
	[1,0,1,0,1,0],
	[1,1,1,0,1,0],
	[1,1,0,1,1,0],
	[0,1,1,1,0,1],
	[1,1,0,1,0,1],
	[0,0,1,1,1,1],
	[1,0,1,0,1,1],
	[1,1,1,0,0,1],
	[1,1,1,1,0,0],
	[0,1,1,1,0,1],
	[1,0,1,1,0,1],
	[0,1,1,0,1,1],
	[1,1,1,1,0,0],
	[1,1,1,1,0,0],
	[1,1,1,1,0,0],
	[1,0,0,1,1,1],
	[1,1,1,0,0,1],
	[1,1,1,1,1,0],
	[1,1,1,1,0,0],
	[1,0,1,1,0,1],
	[1,1,1,0,0,1],
	[1,0,1,1,1,0],
	[0,0,1,0,1,1],
	[1,1,1,0,1,1],
	[1,0,1,1,1,0],
	[1,1,1,0,0,1],
	[1,0,1,1,0,1],
	[1,0,1,0,1,1],
	[1,1,1,0,0,1],
	[1,0,0,1,1,1],
	[1,0,0,0,1,1],
	[1,1,1,0,0,1],
	[1,1,1,1,0,1],
	[1,1,1,1,0,0],
	[1,1,0,1,1,0],
	[1,1,1,1,0,0],
	[0,1,0,1,1,1],
	[0,1,1,1,1,1],
	[1,0,0,1,1,1],
	[1,1,1,0,0,1],
	[1,1,1,1,0,0],
	[0,1,1,1,0,1],
	[1,0,1,1,0,0],
	[0,1,1,0,1,0],
	[1,0,1,1,1,0],
	[0,1,1,0,1,1],
	[1,1,1,1,0,0],
	[1,0,1,1,0,1],
	[1,1,0,0,1,1],
	[1,1,0,1,0,1],
	[1,0,0,1,1,1],
	[1,0,1,0,1,1],
	[1,0,1,0,1,1],
	[1,1,1,0,0,1],
	[1,0,1,1,1,0],
	[0,1,1,0,1,1],
	[0,1,1,1,0,1],
	[0,1,1,1,0,1],
	[1,1,0,1,0,1],
	[1,0,0,1,1,0],
	[1,1,1,0,1,0],
	[1,1,1,1,1,0],
	[1,0,0,1,1,1],
	[1,1,1,0,1,0],
	[1,1,0,1,0,1],
	[0,1,1,1,1,0],
	[0,1,0,1,1,1],
	[1,1,0,1,1,0],
	[1,1,0,1,0,1],
	[0,1,1,1,0,0],
	[1,1,1,1,0,0],
	[0,1,1,1,1,0],
	[1,0,1,1,1,1],
	[0,1,1,0,0,1],
	[0,1,1,1,0,1],
	[0,1,1,1,1,0],
	[1,0,1,1,1,0],
	[1,1,1,0,0,1],
	[1,0,1,1,1,0],
	[1,0,1,0,1,1],
	[1,1,1,0,0,1],
	[1,1,1,1,1,0],
	[1,0,1,1,1,1],
	[1,0,1,0,1,1],
	[1,0,1,0,1,1],
	[1,0,0,0,1,1],
	[1,1,1,0,1,0],
	[1,0,0,1,1,1],
	[1,1,0,0,1,1],
	[1,1,0,1,0,1],
	[1,1,0,1,0,1],
	[1,1,1,1,0,0],
	[0,0,1,1,1,1],
	[1,1,0,0,1,0],
	[0,1,1,1,1,0],
	[0,1,1,1,1,0],
	[0,1,1,1,0,0],
	[0,1,0,1,1,1],
	[1,1,1,1,0,1],
	[1,1,0,1,0,1],
	[0,1,1,1,0,1],
	[1,1,0,1,1,1],
	[1,1,0,1,0,1],
	[1,0,0,1,1,1],
	[0,1,1,0,1,1],
	[1,1,0,1,1,0],
	[0,0,1,1,1,0],
	[1,1,0,0,1,1],
	[0,0,0,1,1,1],
	[0,1,1,0,1,1],
	[0,1,1,1,0,1],
	[1,1,0,1,1,0],
	[0,1,1,1,1,0],
	[1,1,0,1,1,0],
	[0,1,1,1,1,0],
	[0,1,1,1,0,1],
	[1,1,1,1,0,0],
	[1,0,0,1,0,1],
	[0,0,1,0,1,1],
	[1,1,1,0,0,1],
	[0,1,0,1,1,1],
	[1,0,1,1,0,1],
	[1,0,1,0,1,1],
	[1,1,1,0,0,1],
	[0,1,1,1,1,1],
	[1,1,1,1,0,0],
	[1,1,0,1,0,1],
	[0,1,1,1,0,1],
	[1,1,0,1,1,0],
	[1,0,1,1,1,0],
	[1,1,0,0,1,1],
	[1,0,1,1,0,1],
	[1,1,1,0,0,1],
	[0,1,1,1,1,0],
	[1,1,1,1,0,0],
	[0,0,1,1,1,1],
	[1,0,1,0,1,1],
	[0,1,1,0,0,1],
	[1,0,0,1,1,1],
	[1,0,1,0,1,1],
	[1,0,1,0,1,1],
	[1,1,0,0,1,1],
	[1,0,1,1,0,1],
	[1,0,0,0,1,1],
	[1,1,1,0,1,1],
	[0,1,0,1,1,1],
	[1,1,0,1,1,1],
	[1,1,0,1,0,1],
	[0,1,0,1,1,1],
	[1,1,1,1,0,1],
	[0,1,1,1,0,1],
	[1,1,0,1,0,1],
	[0,1,1,1,0,1],
	[0,1,0,1,1,1],
	[0,1,0,1,1,1],
	[0,0,1,1,1,1],
	[1,0,1,0,1,1],
	[1,0,1,0,1,1],
	[0,1,1,0,1,1],
	[1,0,0,1,1,1],
	[0,1,1,0,1,1],
	[0,1,1,1,0,1],
	[1,0,1,1,0,1],
	[1,0,1,0,1,1],
	[1,0,0,0,1,1],
	[1,1,1,0,1,1],
	[0,0,1,1,1,1],
	[1,1,1,0,0,1],
	[1,0,1,1,0,1],
	[1,1,1,0,0,1],
	[1,1,0,1,0,1],
	[0,1,1,1,1,1],
	[1,1,0,1,0,1],
	[1,0,0,1,1,1],
	[1,0,1,0,1,1],
	[1,0,1,0,1,1],
	[1,0,1,0,1,1],
	[0,0,1,0,1,1],
	[1,0,1,0,1,1],
	[0,1,1,0,1,1],
	[0,1,0,1,1,1],
	[1,1,0,1,0,1],
	[1,0,0,1,1,1],
	[1,0,1,0,1,1],
	[1,1,1,0,0,1],
	[1,0,1,1,0,1],
	[1,1,0,0,1,1],
	[0,0,1,1,1,1],
	[0,1,1,0,1,1],
	[0,1,1,1,0,1],
	[1,0,1,1,0,1],
	[1,0,1,0,1,1],
	[1,0,1,0,1,1],
	[0,1,1,0,1,1],
]
